R.......
..#......
....#....
.##......
.........
.........
.....##..
.........
.....#.Y.
..#......
