R.......
..#......
.R....#..
.........
.##......
.....##..
.........
.........
.....#.Y.
..#......
