##...Y..Y...##
#............#
..............
......##......
.....####.....
R...######...G
...########...
...########...
R...######...G
.....####.....
......##......
..............
#............#
##...B..B...##
