Y...Y.....Y...Y
...............
...............
...##.....##...
#Y.##.....##...
#..##.....##...
...##.....##..#
...##.....##.R#
...##.....##...
...............
...............
R...R.....R...R