.....Y.....
...........
..##...##..
..#.....#..
...........
R....#....R
...........
..#.....#..
..##...##..
...........
.....Y.....