....R....
.##...##.
.#.....#.
.........
....#....
.........
.#Y....#.
.##...##.
....Y....